Name	Phenotype	Covariate
calc_bin	Yes	No
collagen_bin	Yes	No
bmi	Yes	Yes
pc1	No	Yes
pc2	No	Yes
pc3	No	Yes
pc4	No	Yes
pc5	No	Yes
pc6	No	Yes
pc7	No	Yes
pc8	No	Yes
pc9	No	Yes
pc10	No	Yes
aegs_type	No	Yes
aexos	No	Yes
aems450k	No	Yes
cohort	No	Yes
study_type	No	Yes
sex	No	Yes